File_Error	Corrected
RAAM	Ram
shyaam	Shyam
Krsna	Krishna
Aum	Aam
Patagaira	Pattagyra
Bandagay	Bandegai
ladkee	Ladki
ludkaa	Ladka
chaawal	Chawal
dudh	Doodh
panee	Pani
maossam	Mausam
soondar	Sundar
mundar	Mandir
gharh	Ghar
rastaah	Rasta
khna	Khana
piyaar	Pyar
dhost	Dost
bhuk	Bhookh
